Date,Transaction Type,Amount,Current Balance
"06/02/2023, 18:35:52",New Account,1800€,1800€
"06/02/2023, 18:40:22",Deposit,300€,2100€
"06/02/2023, 18:40:25",Deposit,400€,2500€
"06/02/2023, 18:40:29",Deposit,100€,2600€
"06/02/2023, 18:40:30",Withdraw,100€,2500€
"06/02/2023, 18:40:31",Withdraw,100€,2400€
"06/02/2023, 18:40:31",Withdraw,100€,2300€
"06/02/2023, 18:40:31",Withdraw,100€,2200€
"06/02/2023, 18:40:31",Withdraw,100€,2100€
"07/02/2023, 18:39:15",Logged in,N/A,2100€
